********************
*                  *
****               *
****               *
I                  *
***                *
***                *
*                  *
*                  *
*                  *
*                  *
*                  *
*                  *
*                  *
*                  *
*                  F
*                  *
*                  *
********************